30
45
0  0  0  0  0  0  0  0  0  0  0  0  0  0  0  0  0  0  0  0  0  0  0  0  0  0  0  0  0  0  0  0  0   0   18  19  0   0  0  0  0  0  0  0  0
0  0  0  0  0  0  0  0  0  0  0  0  0  0  0  0  0  0  0  0  0  0  0  0  2  3  0  0  0  0  0  0  0   0   18  19  0   0  0  0  0  0  0  0  0
0  0  0  0  0  0  0  0  0  0  0  0  0  0  0  0  0  0  0  0  0  0  0  0  4  5  0  0  0  0  0  0  0   0   18  19  0   0  0  0  0  0  0  0  0
1  1  1  0  0  0  0  0  0  0  0  0  0  0  0  0  0  0  0  0  0  0  0  0  0  0  0  0  0  0  0  0  0   0   18  19  0   0  0  0  0  0  0  0  0
1  1  1  2  3  0  0  0  0  0  0  0  0  0  0  0  6  7  0  0  0  0  0  0  0  0  0  0  0  0  0  0  0   0   18  19  0   0  0  0  0  0  0  0  0
1  1  1  4  5  0  0  0  0  0  0  0  0  0  0  0  8  9  0  0  0  0  0  0  0  0  0  0  0  0  0  0  0   0   18  19  0   0  0  0  0  0  0  0  0
1  1  1  0  0  0  0  0  0  0  0  0  0  0  0  0  0  0  0  1  1  1  1  1  1  0  0  0  0  0  0  0  0   0   18  19  0   0  0  0  0  0  0  0  0
1  1  1  0  0  0  0  0  0  0  0  0  0  0  0  0  0  0  0  1  1  1  1  1  1  0  0  0  0  0  0  0  0   0   18  19  0   0  0  0  0  0  0  0  0
1  1  1  0  0  0  0  0  0  0  0  0  0  0  0  0  0  0  0  1  1  1  1  1  1  0  0  0  0  0  0  0  0   0   18  19  0   0  0  0  0  0  0  0  0
1  1  1  0  0  0  0  0  0  0  0  0  0  0  0  0  0  0  0  1  1  1  1  1  1  0  0  0  0  0  0  0  0   0   18  19  0   0  0  0  0  0  0  0  0
1  1  1  0  0  0  0  0  0  0  0  0  0  0  0  0  0  0  0  1  1  1  1  1  1  1  1  1  1  1  0  0  0   0   18  19  0   0  0  0  0  0  0  0  0
1  1  1  0  0  0  0  0  0  0  0  0  0  0  0  0  0  0  0  1  1  1  1  1  1  1  1  1  1  1  0  0  0   0   18  19  0   0  0  0  0  0  0  0  0
1  1  1  0  0  0  0  0  0  0  0  0  0  0  0  0  0  1  1  1  1  1  1  1  1  1  1  1  1  1  0  0  0   0   18  19  0   0  0  0  0  0  0  0  0
1  1  1  1  0  0  0  0  0  0  0  0  0  0  0  0  0  1  1  1  1  0  0  0  0  1  1  1  1  1  0  0  0   0   18  19  0   0  0  0  0  0  0  0  0
1  1  1  1  0  0  0  0  0  0  0  0  0  0  0  0  0  1  1  1  1  0  0  0  0  1  1  1  1  1  1  1  1   0   18  19  0   0  0  0  0  0  0  0  0
1  1  1  1  1  0  0  0  0  0  0  0  0  0  0  0  0  1  1  1  0  0  0  0  0  1  1  1  1  1  1  1  1   0   18  19  0   0  0  0  0  0  0  0  0
1  0  0  1  1  0  0  0  0  0  0  0  0  0  0  0  0  1  1  1  0  0  0  0  0  0  0  0  0  1  1  1  1   0   18  19  0   0  0  0  0  0  0  0  0
1  0  0  1  1  0  0  0  0  0  0  0  0  0  0  0  1  1  1  1  0  0  0  0  0  0  0  0  0  0  1  1  1   0   18  19  0   0  0  0  0  0  0  0  0
1  0  0  1  1  1  0  0  0  0  0  0  0  0  0  0  1  1  1  1  0  0  0  0  0  0  0  0  0  0  1  1  1   10  11  12  13  0  0  0  0  0  0  0  0
0  0  0  1  1  1  0  0  0  0  0  0  0  0  1  1  1  1  0  0  0  0  0  0  0  0  0  0  0  0  1  1  1   1   14  15  0   0  0  0  0  0  0  0  0
0  0  0  1  1  1  0  0  0  0  0  0  0  0  1  1  1  0  0  0  0  0  0  0  0  0  0  0  0  0  0  1  1   10  16  17  13  0  0  0  0  0  0  0  0
0  0  0  0  1  1  1  1  1  1  0  0  0  0  1  1  1  0  0  0  0  0  0  0  0  0  0  0  0  0  0  1  1   1   18  19  0   0  0  0  0  0  0  0  0
0  0  0  0  0  0  1  1  1  1  1  1  1  1  1  1  1  0  0  0  0  0  0  0  0  0  0  0  0  0  0  0  0   0   18  19  0   0  0  0  0  0  0  0  0
0  0  0  0  0  0  0  1  1  1  1  1  1  1  1  1  1  0  0  0  0  0  0  0  0  0  0  0  0  0  0  0  0   0   18  19  0   0  0  0  0  0  0  0  0
0  0  0  0  0  0  0  1  1  1  1  1  1  1  1  1  1  0  0  0  0  0  0  0  0  0  0  0  0  0  0  0  0   0   18  19  0   0  0  0  0  0  0  0  0
0  0  0  0  0  0  0  0  0  1  1  1  1  1  0  0  0  0  0  0  0  0  0  0  0  0  0  0  0  0  0  0  0   0   18  19  0   0  0  0  0  0  0  0  0
0  0  0  0  0  0  0  0  0  0  0  0  0  0  0  0  0  0  0  0  0  0  0  0  0  0  0  0  0  0  0  0  0   0   18  19  0   0  0  0  0  0  0  0  0
0  0  0  0  0  0  0  0  0  0  0  0  0  0  0  0  0  0  0  0  0  0  0  0  0  0  0  0  0  0  0  0  0   0   18  19  0   0  0  0  0  0  0  0  0
0  0  0  0  0  0  0  0  0  0  0  0  0  0  0  0  0  0  0  0  0  0  0  0  0  0  0  0  0  0  0  0  0   0   18  19  0   0  0  0  0  0  0  0  0
0  0  0  0  0  0  0  0  0  0  0  0  0  0  0  0  0  0  0  0  0  0  0  0  0  0  0  0  0  0  0  0  0   0   18  19  0   0  0  0  0  0  0  0  0

