30
45
22 23 22 23 22 23 22 23 22 23 22 23 22 23 22 23 22 23 22 23 22 23 22 23 22 23 22 23 22 23 22 23 22  23  22  23  22  23 22 23 22 23 22 23 22
4  5  4  5  4  5  4  5  4  5  4  5  4  5  4  5  4  5  4  5  4  5  4  5  4  5  4  5  4  5  4  5  4   5   4   5   4   5  4  5  4  5  4  5  4 
0  0  0  0  0  0  0  0  0  0  0  0  0  0  0  0  0  0  0  0  0  0  0  0  0  0  0  0  0  0  0  0  0   0   0   0   0   0  0  0  0  0  0  0  0
1  1  1  0  0  0  0  0  0  0  0  0  0  0  0  0  0  0  0  0  0  0  0  0  0  0  0  0  0  0  0  0  0   0   0   0   0   0  0  0  0  0  0  0  0
1  1  1  2  3  0  0  0  0  0  0  0  0  0  0  0  6  7  0  0  0  0  0  0  0  0  0  0  0  0  0  0  0   0   0   0   0   0  0  0  0  0  0  0  0
1  1  1  4  5  0  0  0  0  0  0  0  0  0  0  0  8  9  0  0  0  0  0  0  0  0  0  0  0  0  0  0  0   0   0   0   0   0  0  0  0  0  0  0  0
1  1  1  0  0  0  0  0  0  0  0  0  0  0  0  0  0  0  0  1  20 1  20 1  1  0  0  0  0  0  0  0  0   0   0   0   0   0  0  0  0  0  0  0  0
1  1  1  0  0  0  0  0  0  0  0  0  0  0  0  0  0  0  0  1  1  1  1  1  1  0  0  0  0  0  0  0  0   0   0   0   0   0  0  0  0  0  0  0  0
1  1  1  0  0  0  0  0  0  0  0  0  0  0  0  0  0  0  0  1  1  1  1  1  1  0  0  0  0  0  0  0  0   0   0   0   0   0  0  0  0  0  0  0  0
1  1  1  0  0  0  0  0  0  0  0  0  0  0  0  0  0  0  0  1  1  1  1  1  1  0  0  0  0  0  0  0  0   0   0   0   0   0  0  0  0  0  0  0  0
1  1  1  0  0  0  0  0  0  0  0  0  0  0  0  0  0  0  0  1  1  1  1  1  1  1  1  1  1  1  0  0  0   0   0   0   0   0  0  0  0  0  0  0  0
1  1  1  0  0  0  0  0  0  0  0  0  0  0  0  0  0  0  0  1  1  1  1  1  1  1  1  1  1  1  0  0  0   0   0   0   0   0  0  0  0  0  0  0  0
1  1  1  0  0  0  0  0  0  0  0  0  0  0  0  0  0  1  1  1  1  1  1  1  1  1  1  1  1  1  0  0  0   0   0   0   0   0  0  0  0  0  0  0  0
1  1  1  1  0  0  0  0  0  0  0  0  0  0  0  0  0  1  1  1  1  0  0  0  0  1  1  1  1  1  0  0  0   0   0   0   0   0  0  0  0  0  0  0  0
1  1  1  1  0  0  0  0  0  0  0  0  0  0  0  0  0  1  1  1  1  0  0  0  0  1  1  1  1  1  1  1  1   0   0   0   0   0  0  0  0  0  0  0  0
1  1  1  1  20 0  0  0  0  0  0  0  0  0  0  0  0  1  1  1  0  0  0  0  0  1  1  1  1  1  1  1  1   0   0   0   0   0  0  0  0  0  0  0  0
1  0  0  1  1  0  0  0  0  0  0  0  0  0  0  0  0  1  1  1  0  0  0  0  0  0  0  0  0  1  1  1  1   0   0   0   0   0  0  0  0  0  0  0  0
1  0  0  1  1  0  0  0  0  0  0  0  0  0  0  0  1  1  1  1  0  0  0  0  0  0  0  0  0  0  1  1  1   0   0   0   0   0  0  0  0  0  0  0  0
1  0  0  1  1  1  0  0  0  0  0  0  0  0  0  0  1  1  1  1  0  0  0  0  0  0  0  0  0  0  1  1  1   0   0   0   0   0  0  0  0  0  0  0  0
0  0  0  1  1  1  0  0  0  0  0  0  0  0  1  1  1  1  0  0  0  0  0  0  0  0  0  0  0  0  1  1  1   1   0   0   0   0  0  0  0  0  0  0  0
0  0  0  1  1  1  0  0  0  0  0  0  0  0  1  1  1  0  0  0  0  0  0  0  0  0  0  0  0  0  0  1  1   0   0   0   0   0  0  0  0  0  0  0  0
0  0  0  0  1  1  1  1  1  1  0  0  0  0  1  1  1  0  0  0  0  0  0  0  0  0  0  0  0  0  0  1  1   1   0   0   0   0  0  0  0  0  0  0  0
0  0  0  0  0  0  1  1  1  1  1  1  1  1  1  1  1  0  0  0  0  0  0  0  0  0  0  0  0  0  0  0  0   0   0   0   0   0  0  0  0  0  0  0  0
0  0  0  0  0  0  0  1  1  1  1  1  1  1  1  1  1  0  0  0  0  0  0  0  0  0  0  0  0  0  0  0  0   0   0   0   0   0  0  0  0  0  0  0  0
0  0  0  0  0  0  0  1  1  1  1  1  1  1  1  1  1  0  0  0  0  0  0  0  0  0  0  0  0  0  0  0  0   0   0   0   0   0  0  0  0  0  0  0  0
0  0  0  0  0  0  0  0  0  1  1  1  1  1  0  0  0  0  0  0  0  0  0  0  0  0  0  0  0  0  0  0  0   0   0   0   0   0  0  0  0  0  0  0  0
0  0  0  0  0  0  0  0  0  0  0  0  0  0  0  0  0  0  0  0  0  0  0  0  0  0  0  0  0  0  0  0  0   0   0   0   0   0  0  0  0  0  0  0  0
0  0  0  0  0  0  0  0  0  0  0  0  0  0  0  0  0  0  0  0  0  0  0  0  0  0  0  0  0  0  0  0  0   0   0   0   0   0  0  0  0  0  0  0  0
0  0  0  0  0  0  0  0  0  0  0  0  0  0  0  0  0  0  0  0  0  0  0  0  0  0  0  0  0  0  0  0  0   0   0   0   0   0  0  0  0  0  0  0  0
0  0  0  0  0  0  0  0  0  0  0  0  0  0  0  0  0  0  0  0  0  0  0  0  0  0  0  0  0  0  0  0  0   0   0   0   0   0  0  0  0  0  0  0  0

