30
45
22 23 22 23 22 23 22 23 22 23 22 23 22 23 22 23 22 23 22 23 22 23 22 23 22 23 22 23 22 23 22 23 22  23  22  23  22  23 22 23 22 23 22 23 22
4  5  4  5  4  5  4  5  4  5  4  5  4  5  4  5  4  5  4  5  4  5  4  5  4  5  4  5  4  5  4  5  4   5   4   5   4   5  4  5  4  5  4  5  4 
0  0  0  0  0  0  0  0  0  0  0  0  0  0  0  0  0  0  0  0  0  0  0  0  0  0  0  0  0  0  0  0  0   0   0   0   0   0  0  0  0  0  0  0  0
0  0  0  0  0  0  0  0  31 0  0  0  0  0  0  0  0  0  30 30 30 30 0  0  0  0  0  0  0  0  0  0  0   0   0   0   0   0  0  0  0  0  0  0  0
0  0  0  0  0  0  0  0  0  0  0  0  0  0  0  0  0  0  0  0  0  0  0  0  0  25 6  6  6  6  6  6  6   6   6   8   0   0  0  0  0  0  0  0  0
0  0  0  0  0  25 6  6  6  6  6  6  27 6  6  6  6  6  6  6  6  6  6  27 6  26 0  0  0  0  0  0  0   0   0   7   0   0  0  0  0  0  0  0  0
0  0  0  0  0  7  0  0  0  0  0  0  7  0  0  0  0  0  0  0  0  0  0  7  0  0  0  0  0  0  0  0  0   0   0   7   0   0  0  0  0  0  0  0  0
0  0  0  0  0  7  0  30 30 30 0  0  7  0  2  3  0  0  0  0  0  0  0  7  0  0  0  0  2  3  0  0  0   0   0   7   0   0  0  0  0  0  0  0  0
0  0  0  0  0  7  0  30 30 30 0  0  7  0  4  5  0  0  31 31 0  0  0  7  0  0  31 0  4  5  0  0  0   0   0   7   0   0  0  0  0  0  0  0  0
0  0  0  0  0  7  0  0  0  0  0  0  7  0  0  0  0  0  0  0  0  0  0  7  0  0  0  0  0  0  0  0  0   0   0   7   0   0  0  0  0  0  0  0  0
6  6  6  6  6  9  0  0  0  0  0  0  7  0  0  0  0  0  0  0  0  0  0  7  0  0  0  0  0  0  0  0  0   0   0   7   0   0  0  0  0  0  0  0  0
0  0  0  0  0  7  0  0  2  3  0  0  24 6  6  6  6  6  6  6  6  6  6  29 6  6  6  6  6  6  6  6  6   6   6   29  6   6  6  6  6  6  6  6  6
0  0  0  0  0  7  0  0  4  5  0  0  0  0  0  0  0  0  0  0  0  0  0  0  0  0  0  0  0  0  0  0  0   0   0   0   0   0  0  0  0  0  0  0  0
0  0  0  0  0  7  0  0  2  3  0  0  0  0  0  31 0  0  0  0  0  0  0  0  0  0  0  0  0  0  0  0  0   0   0   0   0   2  3  0  0  0  0  0  0
0  0  0  0  0  7  0  0  4  5  0  0  31 0  0  0  2  3  0  0  0  30 30 30 30 30 0  0  0  0  0  0  2   3   0   0   0   4  5  0  0  0  0  0  0
0  0  0  0  0  7  0  31 0  0  0  0  0  0  0  0  4  5  0  0  0  0  0  0  0  0  0  0  0  0  0  0  4   5   0   0   0   0  0  0  0  0  0  0  0
0  0  0  0  0  7  0  0  0  0  0  0  0  0  0  0  0  0  0  0  0  0  0  0  0  0  0  0  0  0  0  0  0   0   0   0   0   0  0  0  0  0  0  0  0
0  0  0  0  0  28 6  6  6  6  6  6  6  6  6  6  6  6  27 6  6  6  6  6  6  6  6  6  6  6  6  6  6   6   6   6   6   6  6  6  6  6  6  6  6
0  0  0  0  0  7  0  0  0  0  0  0  0  0  0  0  0  0  7  0  0  0  0  0  0  0  0  0  0  0  0  0  0   0   0   0   0   0  0  0  0  0  0  0  0
0  0  0  0  0  7  0  30 0  0  0  0  0  2  3  0  0  0  7  0  2  3  0  31 0  0  0  0  0  0  0  0  0   0   0   0   0   0  0  0  0  0  0  0  0
0  0  0  0  0  7  0  30 0  0  31 0  0  4  5  0  0  0  7  0  4  5  0  0  0  0  0  25 6  6  6  6  6   6   6   6   6   6  8  0  0  0  0  0  0
0  0  0  0  0  7  0  30 0  0  0  0  0  0  0  0  0  0  7  0  0  0  0  0  0  0  0  7  0  0  0  0  0   0   0   0   0   0  7  0  0  0  0  0  0
0  0  0  0  0  7  0  0  0  0  0  0  0  0  0  0  0  0  7  0  0  0  0  0  31 0  0  7  0  0  0  0  0   0   0   0   0   0  7  0  0  0  0  0  0
0  0  0  0  0  7  0  0  0  0  0  0  0  0  0  0  0  0  7  0  0  0  0  0  0  0  0  7  0  0  0  0  0   0   0   0   0   0  24 6  6  6  6  6  6
0  0  0  0  0  24 6  6  6  6  27 6  6  6  6  6  6  6  29 6  6  27 6  6  6  6  6  26 0  0  0  0  0   0   0   0   0   0  0  0  0  0  0  0  0
0  0  0  0  0  0  0  0  0  0  7  0  0  0  0  0  0  0  0  0  0  7  0  0  0  0  0  0  0  0  2  3  0   0   0   0   0   0  0  0  0  0  0  0  0
0  0  0  0  0  0  0  0  0  0  24 6  6  6  6  6  6  6  6  6  6  26 0  0  0  0  0  0  0  0  4  5  0   0   0   0   0   0  0  0  0  0  0  0  0
0  0  0  0  0  0  0  0  0  0  0  0  0  0  0  0  0  0  0  0  0  0  0  0  0  0  0  0  0  0  0  0  0   0   0   0   0   0  0  0  0  0  0  0  0
3  2  3  2  3  2  3  2  3  2  3  2  3  2  3  2  3  2  3  2  3  2  3  2  3  2  3  2  3  2  3  2  3   2   3   2   3   3  2  3  2  3  2  3  2  
22 23 22 23 22 23 22 23 22 23 22 23 22 23 22 23 22 23 22 23 22 23 22 23 22 23 22 23 22 23 22 23 22  23  22  23  22  23 22 23 22 23 22 23 22
